small - смол - маленький
large - ла:дж - большой
young - ян - молодой
different - дифрэнт - разный, другой
important - импо:тэнт - важный
right - райт - правильный
only - оунли - единственный
public - паблик - публичный, общественный
sure - шуэ - уверенный
low - лоу - низкий
early - ё:ли - ранний
able - эйбл - способный
local - лоукэл - местный
late - лейт - поздний
major - мейджэ - главный, крупный
better - бетэ - лучше, лучший
strong - строн - сильный
possible - посэбл - возможный
whole - хоул - целый, весь
clear - клиэ - ясный, понятный
recent - ри:сэнт - недавний
certain - сё:тэн - определённый, уверенный
personal - пё:сэнэл - личный
difficult - диффикэлт - трудный
available - эвейлэбл - доступный
likely - лайкли - вероятный
single - сингл - единственный, одинокий
current - карэнт - текущий
wrong - рон - неправильный
private - прайвэт - частный
past - па:ст - прошлый
foreign - форэн - иностранный
fine - файн - хороший, прекрасный
common - комэн - общий, распространённый
poor - пуэ - бедный, плохой
significant - сигнификэнт - значительный
similar - симэлэ - похожий
hot - хот - горячий
simple - симпл - простой
physical - физикэл - физический
general - дженэрэл - общий
environmental - инвайрэнментл - экологический
various - вээриэс - различные
entire - интайэ - весь, целый
legal - ли:гэл - юридический, законный
cold - коулд - холодный
nice - найс - приятный
huge - хьюдж - огромный
be - би: - быть
can - кэн - мочь
get - гет - получать
would - вуд - бы (частица)
take - тейк - брать
come - кам - приходить
could - куд - мог бы
want - уонт - хотеть
look - лук - смотреть
find - файнд - находить
give - гив - давать
tell - тел - говорить, рассказывать
should - шуд - следует
try - трай - пытаться
ask - а:ск - спрашивать, просить
become - бикам - становиться
leave - ли:в - уходить, покидать
put - пут - класть, ставить
mean - ми:н - значить, иметь в виду
keep - ки:п - держать, сохранять
let - лет - позволять
begin - бигин - начинать
seem - си:м - казаться
turn - тё:н - поворачивать(ся)
show - шоу - показывать
hear - хиэ - слышать
believe - били:в - верить
hold - хоулд - держать
bring - брин - приносить
happen - хэпэн - происходить
must - маст - должен
write - райт - писать
provide - прэвайд - предоставлять, обеспечивать
sit - сит - сидеть
stand - стэнд - стоять
lose - лу:з - терять
pay - пей - платить
include - инклу:д - включать
continue - кэнтинью: - продолжать
learn - лё:н - учить(ся), узнавать
follow - фолоу - следовать
speak - спи:к - говорить
allow - элау - позволять
add - эд - добавлять
spend - спенд - тратить, проводить (время)
grow - гроу - расти
walk - во:к - ходить, гулять
offer - офэ - предлагать
remember - римембэ - помнить
consider - кэнсидэ - рассматривать, учитывать
appear - эпиэ - появляться
serve - сё:в - служить
expect - икспект - ожидать
build - билд - строить
stay - стей - оставаться
fall - фо:л - падать
cut - кат - резать
reach - ри:ч - достигать
kill - кил - убивать
remain - римейн - оставаться
year - йиэ - год
way - уэй - путь, способ
man - мэн - мужчина
hand - хэнд - рука
place - плейс - место
case - кейс - случай, дело
week - уи:к - неделя
company - кампэни - компания
government - гавэнмэнт - правительство
point - пойнт - точка, момент, смысл
room - ру:м - комната, место
area - э:риэ - область, район
story - сто:ри - история, рассказ
month - манс - месяц
lot - лот - много, масса
study - стади - учёба, исследование
eye - ай - глаз
issue - ишу: - вопрос, проблема
side - сайд - сторона
kind - кайнд - вид, тип
head - хед - голова
service - сё:вис - услуга, сервис
hour - ауэ - час
line - лайн - линия
member - мембэ - член (группы)
idea - айдиэ - идея
back - бэк - спина; назад
parent - пээрэнт - родитель
others - аðэз - другие
person - пё:сэн - человек
art - а:т - искусство
war - во: - война
reason - ри:зэн - причина
research - рисё:ч - исследование
guy - гай - парень
air - эа - воздух
teacher - ти:чэ - учитель
force - фо:с - сила
took - тук - взял
enjoy - инджой - наслаждаться
bought - бо:т - купил
immediately - ими:диэтли - немедленно
learnt - лё:нт - выучил
during - дьюринг - в течении
always - о:лвэйз - всегда
arrived - эрайвд - прибыл
corner - ко:нэ - угол
sick - сик - больной
to be honest - ту би онест - если быть честным
everything - эврисэнг - всё
vegetable - веджэтэбл - овощь
don't mind - доунт майнд - быть не против
sure - шуэ - уверен
awful - о:фул - ужасный
