be - was/were - been - быть [би:]
go - went - gone - идти [гоу]
see - saw - seen - видеть [си:]
take - took - taken - брать [тейк]
come - came - come - приходить [кам]
get - got - got/gotten - получать [гет]
give - gave - given - давать [гив]
make - made - made - делать [мейк]
know - knew - known - знать [ноу]
think - thought - thought - думать [синк]
say - said - said - говорить [сей]
tell - told - told - рассказывать [тел]
find - found - found - находить [файнд]
leave - left - left - уходить, покидать [ли:в]
feel - felt - felt - чувствовать [фи:л]
bring - brought - brought - приносить [брин]
begin - began - begun - начинать [биˈгин]
keep - kept - kept - держать, сохранять [ки:п]
hold - held - held - держать [хоулд]
write - wrote - written - писать [райт]
stand - stood - stood - стоять [стэнд]
hear - heard - heard - слышать [хиэ]
let - let - let - позволять [лет]
mean - meant - meant - значить [ми:н]
set - set - set - устанавливать [сет]
meet - met - met - встречать [ми:т]
run - ran - run - бежать [ран]
pay - paid - paid - платить [пей]
sit - sat - sat - сидеть [сит]
speak - spoke - spoken - говорить [спи:к]
lie - lay - lain - лежать [лай]
lead - led - led - вести [ли:д]
read - read - read - читать [ри:д]
grow - grew - grown - расти [гроу]
lose - lost - lost - терять [лу:з]
fall - fell - fallen - падать [фо:л]
send - sent - sent - отправлять [сенд]
build - built - built - строить [билд]
understand - understood - understood - понимать [ˌандэˈстэнд]
draw - drew - drawn - рисовать [дро:]
break - broke - broken - ломать [брейк]
spend - spent - spent - тратить [спенд]
cut - cut - cut - резать [кат]
rise - rose - risen - подниматься [райз]
drive - drove - driven - водить [драйв]
buy - bought - bought - покупать [бай]
wear - wore - worn - носить [уэа]
choose - chose - chosen - выбирать [чу:з]
seek - sought - sought - искать [си:к]
throw - threw - thrown - бросать [сроу]
catch - caught - caught - ловить [кэч]
deal - dealt - dealt - иметь дело [ди:л]
win - won - won - побеждать [уин]
forget - forgot - forgotten - забывать [фэˈгет]
lay - laid - laid - класть [лей]
strike - struck - struck - ударять [страйк]
hang - hung - hung - висеть [хэнг]
shoot - shot - shot - стрелять [шу:т]
teach - taught - taught - учить [ти:ч]
sell - sold - sold - продавать [сел]
feed - fed - fed - кормить [фи:д]
fight - fought - fought - бороться [файт]
hide - hid - hidden - прятать [хайд]
hit - hit - hit - ударять [хит]
hurt - hurt - hurt - причинять боль [хё:т]
learn - learnt/learned - learnt/learned - учить [лё:н]
lend - lent - lent - одалживать [ленд]
light - lit - lit - зажигать [лайт]
put - put - put - класть [пут]
quit - quit - quit - бросать [куит]
ride - rode - ridden - ехать [райд]
ring - rang - rung - звонить [рин]
shake - shook - shaken - трясти [шейк]
shine - shone - shone - светить [шайн]
show - showed - shown - показывать [шоу]
shut - shut - shut - закрывать [шат]
sing - sang - sung - петь [син]
sink - sank - sunk - тонуть [синк]
sleep - slept - slept - спать [сли:п]
slide - slid - slid - скользить [слайд]
spin - spun - spun - крутить [спин]
spread - spread - spread - распространять [спред]
spring - sprang - sprung - прыгать [сприн]
steal - stole - stolen - красть [сти:л]
stick - stuck - stuck - прилипать [стик]
sting - stung - stung - жалить [стин]
swear - swore - sworn - клясться [суэа]
sweep - swept - swept - подметать [суи:п]
swim - swam - swum - плавать [суим]
swing - swung - swung - качаться [суин]
tear - tore - torn - рвать [тэа]
wake - woke - woken - просыпаться [уейк]
weep - wept - wept - плакать [уи:п]
wind - wound - wound - заводить [уайнд]
